NO ./path_to_the_north_texture.xpm
SO ./path_to_the_south_texture.xpm
WE ./path_to_the_west_texture.xpm
EA ./path_to_the_east_texture.xpm

F 220,100,0
C 225,30,0

    1111111111111111111111111
        100000000011000000011110111
        1101100000111000000000000111
        110010000000000000000000001
11111111101100000111000000000000101
10000000001100000111011111111111111
11110111111111011100000010001
11110111111111011101010010001
11000000110101011100000010001
10000000000000011000000100001
10000000000000001101010010001
11000001110101011111011110N01111
11110111 1110101 101111010001 101
11111111 1111111 111111111111 1111
